1111111111111111
1000E10000000001
1010010100100001
1010010010100001
1000P00000000001
1010010100100101
10100100101C0101
1111111111111111
